############
#        O #
#   P   ####
#        P #
#######    #
#  O ##    #
#    ##    #
#          #
#      XX  #
#      #   #
############
