###########
#   O    O #     #########
#     ######     #    X O#
#          #     #  X    #
#     #    ##### #  X    #
#######        ###     X #
#  O ##    ##   X  OOO X #
#  # ##    ##  ### OPO X #
#          #   # #########
# X#    XX #####
#     O #  #
############